111111111111111111
100000000000000001
101010101010101001
100000000000000001
101010101010101001
100000000000000001
101010101010101001
100000000000000001
101010101010101001
100000000000000001
101010101010101001
100000000000000001
111111111111111111