1111111111111
1000000000001
1010010100101
1000100010001
1001000001001
1010000000101
1000101010001
1010000000101
1001000001001
1000100010001
1010010100101
1000000000001
1111111111111